 1  1  1  1  1  1  1  1  1  1  1  1  1  1  1  1  1  1  1  1  1  1  1  1  1  1  1  1  1  1
 1  1  1  1  1  1  1  1  1  1  1  1  1  1  1  1  1  1  1  1  1  1  1  1  1  1  1  1  1  1
 1  1  1  1  1  1  1  1  1  1  1  1  1  1  1  1  1  1  1  1  1  1  1  1  1  1  1  1  1  1
 2  1  1  1  1  1  1  1  1  1  1  1  1  1  1  1  1  1  1  1  1  1  1  1  1  1  1  1  1  1
 2  2  2  1  1  1  1  1  1  1  1  1  1  1  1  1  1  1  1  1  1  1  1  1  1  1  1  1  1  1
 2  2  2  2  2  2  1  1  1  1  1  1  1  1  1  1  1  1  1  1  1  1  1  1  1  1  1  1  1  1
 2  2  2  2  2  2  2  1  1  1  1  1  1  1  1  1  1  1  1  1  1  1  1  1  1  1  1  1  1  1
 2  2  2  2  2  2  2  2  2  1  1  1  1  1  1  1  1  1  1  1  1  1  1  1  1  1  1  1  1  1
 2  2  2  2  2  2  2  2  2  2  2  1  1  1  1  1  1  1  1  1  1  1  1  1  1  1  1  1  1  1
 2  2  2  2  2  2  2  2  2  2  2  2  1  1  1  1  1  1  1  1  1  1  1  1  1  1  1  1  1  1
 2  2  2  2  2  2  2  2  2  2  2  2  2  2  1  1  1  1  1  1  1  1  1  1  1  1  1  1  1  1
 2  2  2  2  2  2  2  2  2  2  2  2  2  2  2  1  1  1  1  1  1  1  1  1  1  1  1  1  1  1
 2  2  2  2  2  2  2  2  2  2  2  2  2  2  2  2  2  1  1  1  1  1  1  1  1  1  1  1  1  1
 4  4  4  4  2  2  2  2  2  2  2  2  2  2  2  2  2  2  1  1  1  1  1  1  1  1  1  1  1  1
 8  8  4  4  4  4  4  2  2  2  2  2  2  2  2  2  2  2  2  1  1  1  1  1  1  1  1  1  1  1
 8 33 33 33  8  4  4  4  4  4  2  2  2  2  2  2  2  2  2  2  1  1  1  1  1  1  1  1  1  1
33  8 33 33 33 33 33  8  4  4  4  2  2  2  2  2  2  2  2  2  2  1  1  1  1  1  1  1  1  1
 0  0 33 33 15 33 33 33 33  8  4  4  4  2  2  2  2  2  2  2  2  2  1  1  1  1  1  1  1  1
 0  0  0 33 33 33 33 33 33 33 33  8  4  4  2  2  2  2  2  2  2  2  2  1  1  1  1  1  1  1
 0  0  0  0 33 33 33 33 33 33 33 33 33  4  4  4  2  2  2  2  2  2  2  2  1  1  1  1  1  1
 0  0  0  0  0 33 33 33 33 33 33 33  6 33  8  4  4  2  2  2  2  2  2  2  2  2  1  1  1  1
 0  0  0  0  0  0 33 33 33 33 33 33 33 33 33 32  4  4  2  2  2  2  2  2  2  2  1  1  0  0
 0  0  0  0  0  0  0  6 33 33  5  5  9 33 33 33 33  4  4  2  2  2  2  2  2  2  2  0  1  1
 0  0  0  0  0  0  0  0 33 33 33 33 33 33 33 33 33 33  8  4  2  2  2  2  0  2  2  0  0  0
 0  0  0  0  0  0  0  0  0 33 22 33 33 33 33 33 33 33 33  8  4  4  2  2  0  0  0  0  0  0
 0  0  0  0  0  0  0  0  0  0 33 33 33 33 33 33 33 33 33 33  8  0  0  0  0  0  0  0  0  0
 0  0  0  0  0  0  0  0  0  0  0 33 33 33 33 33 33 33 33  0  0  0  0  0  0  0  0  0  0  0
 0  0  0  0  0  0  0  0  0  0  0  0 33 33 33 33 33 33 33 33 33  0  0  0  0  0  0  0  0  0
 0  0  0  0  0  0  0  0  0  0  0  0  0 33 33 33 33  0  0 33 33 33 33  8  4  2  2  0  0  0
 0  0  0  0  0  0  0  0  0  0  0  0  0  0 33 33  0  0  0  0  0  0  0  0  0  0  0  0  0  0
